https://deployeveryday.com/2020/04/13/vpn-aws-azure-terraform.html


US East (Ohio)	us-east-2	
US East (N. Virginia)	us-east-1	
US West (N. California)	us-west-1	
US West (Oregon)	us-west-2	
Africa (Cape Town)	af-south-1	rds.af-south-1.amazonaws.com	HTTPS
Asia Pacific (Hong Kong)	ap-east-1	rds.ap-east-1.amazonaws.com	HTTPS
Asia Pacific (Mumbai)	ap-south-1	rds.ap-south-1.amazonaws.com	HTTPS
Asia Pacific (Osaka-Local)	ap-northeast-3	rds.ap-northeast-3.amazonaws.com	HTTPS
Asia Pacific (Seoul)	ap-northeast-2	rds.ap-northeast-2.amazonaws.com	HTTPS
Asia Pacific (Singapore)	ap-southeast-1	rds.ap-southeast-1.amazonaws.com	HTTPS
Asia Pacific (Sydney)	ap-southeast-2	rds.ap-southeast-2.amazonaws.com	HTTPS
Asia Pacific (Tokyo)	ap-northeast-1	rds.ap-northeast-1.amazonaws.com	HTTPS
Canada (Central)	ca-central-1	
China (Beijing)	cn-north-1	rds.cn-north-1.amazonaws.com.cn	HTTPS
China (Ningxia)	cn-northwest-1	rds.cn-northwest-1.amazonaws.com.cn	HTTPS
Europe (Frankfurt)	eu-central-1	rds.eu-central-1.amazonaws.com	HTTPS
Europe (Ireland)	eu-west-1	rds.eu-west-1.amazonaws.com	HTTPS
Europe (London)	eu-west-2	rds.eu-west-2.amazonaws.com	HTTPS
Europe (Milan)	eu-south-1	rds.eu-south-1.amazonaws.com	HTTPS
Europe (Paris)	eu-west-3	rds.eu-west-3.amazonaws.com	HTTPS
Europe (Stockholm)	eu-north-1	rds.eu-north-1.amazonaws.com	HTTPS
Middle East (Bahrain)	me-south-1	rds.me-south-1.amazonaws.com	HTTPS
South America (SÃ£o Paulo)	sa-east-1	rds.sa-east-1.amazonaws.com	HTTPS
AWS GovCloud (US-East)	us-gov-east-1	
AWS GovCloud (US-West)	us-gov-west-1	
